{
    "sw-cms": {
        "blocks": {
            "moorl-column-layout": {
                 "1": "1",
                 "1-1": "1-1",
                 "1-1-1": "1-1-1",
                 "1-1-1-1": "1-1-1-1",
                 "1-1-1-1-1": "1-1-1-1-1",
                 "1-1-1-1-1-1": "1-1-1-1-1-1",
                 "2-3": "2-3",
                 "3-2": "3-2"
            }
        }
    }
}
